
      NO         ./textures/pattern.xpm


    SO          ./textures/wall.xpm

  WE      ./textures/pld2.xpm

                EA ./textures/pld.xpm

     F     147   ,   24  ,    231



     C   125  ,32   ,  123






      1111111111111111111111111111111111111
      1000001000000001001001000001000000001
      1001111001111001001001001111001111111
1000000000001001001001001001000000001
1001111001111111001001001001111111001
100000     1000000000000001000000001000001
100100     1111111001001111001111111111001
100100     1000000001000000001000000001001
1111111111001001111001111001111001001
1001000001001000001001000001000000001
1001001111001111001111001111111111111
1000001000000001000001000000000000001
1111001001111001111111111001001111111
1000000001000000000000000001000000001
1001001001111001001111111111111001111
1001001000001001000001000000000000001
1001001111111001111001001001111001001
1001000000001000001001001001000001001
1111001111111001001111111111001111111
1000000     00100      1001001001000001000000001
1111111111001001001001111001111001111
1000000000000001001000000001001000001
1001111001001111111111111001001001001
10000010010000000010000000000000010N1
1111111111111111111111111111111111111
