
NO ./textures/wall.xpm
EA           ./textures/wall.xpm
WE       ./textures/wall.xpm
SO      ./textures/wall.xpm


C     ./textures/wood.xpm
F     ./textures/stone.xpm



11111111111111111111111111111111111111111111111
1000000000000000000000001001000001000000011111
11111111111111111111110010010011110011111111111
1000000000001001001001001001000000001
1001111111111111001001001001111111001
100001     1000000000000001000000000011111
100101     1111111001001111001111110000001
100101     1000000001000000001000000111111
100111111110100111100111100111100111
1001000001001000001001000001000000001
100100111100111100111100000001111001
1000001000000001000001000000000000001
1111001001111000001111110010000011111
1000000001000000000000000000000000001
10010010011110010011111111111110011111
100100100000100100000100E00000000000001
10010011111110011110010010011110010011
1001000000001000001001001001000001001
1111001111111000001111111100001111111111
1000001    100010001      10000010000001
1111111111111000001111111101111000111111
1000000000000001000000000010010000001
1001111001001111111111111001001001001
1000001001000000001000000000000001001
11111111111111111111111111111111111111
