
NO      ./textures/pattern.xpm


SO       ./textures/wall.xpm




WE           ./textures/pld2.xpm



EA      ./textures/pld.xpm


F     255,24,231



C     125,32,123



      1111111111     111111111111111111111111111
      100000100011  111101001001000001000000001
1111111001111001111111001001001111001111111
1000000000001001001001001001000000001
1001111111111111001001001001111111001
100001     1000000000000001000000000011111
100101     1111111001001111001111110000001
100101     1000000001000000001000000011111
1001111111101001111001111001111001001
1001000001001000001001000001000000001
1001001111001111001111001111111111111
1000001000000001000001000000000000001
1111001001111000001111110010000011111
1000000001000000000000000001000000001
1001001001111001001111111111111001111
1001001000001001000001000000000000001
1001001111111001111001001001111001001
1001000000001000001001001001000001001
1111001111111000001111111100001111111111
1000001    100010001      10010010000001
1111111111111000001111110001111000111111
1000000000000001001000000001001000001
1001111001001111111111111001001001001
10000010010000000010000000000000010N1
1111111111111111111111111111111111111
