
NO ./textures/pattern.xpm
EA      ./textures/pld.xpm
WE           ./textures/pld2.xpm
SO       ./textures/wall.xpm


C     80,80,80
F     127,127,127



    1111111111     111111111111111111111111111
    10000100011  111101001001000001000000011
1111111001111001111111001001001111001111111
1000000000001001001001001001000000001
1001111111111111001001001001111111001
100001     0000000000000001000000000011111
100101     1111111001001111001111110000001
100101     1000000001000000001000000111111
100111111110100111100111100111100111
1001000001001000001001000001000000001
100100111100111100111100000001111001
1000001000000001000001000000000000001
1111001001111000001111110010000011111
1000000001000000000000000000000000001
10010010011110010011111111111110011111
100100100000100100000100000000000000001
10010011111110011110010010011110010011
1001000000001000001001001001000001001
1111001111111000001111111100001111111111
1000001    100010001      10010010000001
1111111111111000001111111101111000111111
1000000000000001001000000001001000001
1001111001001111111111111001001001001
10000010010000000010000000000000010N1
1111111111111111111111111111111111111
