
NO ./textures/bob_ross.xpm
SO      ./textures/pld.xpm
WE           ./textures/pld2.xpm
EA       ./textures/wall.xpm


C     80,80,80
F     127,127,127

111111111111111111111111111111111
100000000010000000000010000000001
100000000001111001111100000000001
1000N0000000111001111000000000001
100000000100000000000001000000001
100000000100001111100001000000001
100000000110000010000011000000001
100000000110000010000011000000001
100000000100001111100001000000001
100000000100000000000001000000001
100000000000111001111000000000001
100000000001111001111100000000001
10N000000010000000000010000000001
111111111111111111111111111111111
